111111111111111
144432222222221
142432222222221
122232222222221
122222222223331
122222233222221
122232233222221
122232222223331
122232222222221
111111111111111
