111111111111111
144422222222221
142422222222221
122322222222221
122322232223331
122322233222221
122322232222221
122222222223331
122222222222221
111111111111111
